################################################################################
################################################################################
################################################################################
################################################################################
#######   ######################################################################
######     #############################  ####  ################################
######      ####   C    ######      ###    ##    ###############################
######       ##          ####        ##           ##############################
######                    ##               ##      #############################
#######      ##                      ##    ###         #########################
#######     #### #        ##         ##    ####         ########################
#######   C##### ###      ##        ####  #######       ########################
########  ###### ####     ###      ###############     #########################
################ #####    ####     ################ ############################
################ ######  #####      ############### ############################
################ #############      ############### ############################
################ ##############    ###############   ###########################
###############   ############## ################     ##########################
#####    #####     ############# ################     ##########################
####                ###########    ###############   ###########################
####     #####     ###########      ############################################
#####   #######  #############      ############################################
###############################    #############################################
################################################################################


Seed: 3551281415
