################################################################################
################################################################################
##  %#######################################%    #########          ############
#     ######################################                        ##   #######
#     ######################  ##############     #########               #######
#     #####################    #############     #########          ##   #######
##   ###############   ###     #############     #########          ##       ###
### ################           ######    ###### ##########          ##       ###
### ################   ###               ###### ##########         %##       ###
### ########    ####   ##      ######    ###### ##########          ##       ###
### ########           ##       #####    ###      ########         C##       ###
#      ## C     ####   ###       ####    ##       ########          ##      C###
#               ##     ####%     ####                               ##       ###
#      ##       ##    ######    #####%   ##       ########          ##       ###
#      ##       ##    ###############    ##       ########          ##       ###
#      ##       ##    ###############    ##%      ######### ##########       ###
#      ##       ##    ###############    ##       ######### ##########       ###
#      ## %     ##%   ######## %###########       #####        #######   #######
#      #####    ##    #######    ##########                    #################
#      #####################                      #####        #################
#      #####################     ##########       #####        #################
#      ######################   #######################    %   #################
#%     #########################################################################
################################################################################


Seed: 355145
