################################################################################
#############################################################               ####
#############################################################               ####
#######################          ############################               ####
##########           ##          ############################               ####
##########           ##          ############################               ####
##########                       ############################               ####
##########           ##          ################   ########## ######### #######
##########           ##          ################   ########## ######### #######
#     ####           ### ##########        ####      #####      #######      ###
#                                                              C#######      ###
#     ####           ### ##########        ####      #####                   ###
#     ####           ### ##########        ####      #####      #######      ###
#     ####           ##    ########        ######   ######   ##########      ###
#     ####                      ###        ############################      ###
#     ####           ##                    ############################      ###
##########           ##         ###        ############################      ###
##########           ##    ########        ############################      ###
###################################        ############################      ###
#######################################################################      ###
#######################################################################      ###
#######################################################################      ###
################################################################################
################################################################################


Seed: 3691402910
