                                                       #                        
                                                                    #           
                                 #                        #                     
                #               #                                               
                               #                #                               
                               #                 #                   #          
             #                                    #            @                
                                         #         # #                          
 @        #                        ########                             #       
          #                  #     #      #  #        #                         
           #                  #    #      #            #                        
             #                #        @  #   #         #                       
                               #   ########                            #        
                                     # #   #    ##########                      
                   #       ########### #        #                               
    #                      #           #        ##########                      
                    #      #   #########                              #         
                           #   #         #                                      
                   #########   #                                                
                   #           #             #              #                   
                   #           #                                     #          
               #   #           #                                                
                   #           #              #                                 
                               #                                                
