################################################################################
################################################################################
################################################################################
################################################################################
####################################################################   #########
#######################################################   ##########   #########
########################     ##########################   ########         #####
#######           ###           ####          #####            ###    @    #####
#######                         ####                           ###         #####
#######           ###           ####          #####            #####   # #######
#####################           ####            ###            ######### #######
#####################           ####            ########### ############ #######
########                        ####            ########### ##########    ######
########          ######## #########            #####              ##      #####
########          ######## #########                                       #####
########################## #########            #####              ##      #####
########################## #########            #####              ##      #####
##########################       ###            #####            ####      #####
##########################       ###            #####            ####      #####
##########################       ###            ################################
##########################       ###            ################################
##########################       ###     <      ################################
####################################            ################################
################################################################################