################################################################################
################################################################################
##########################################################     #################
##########################################################     ####      #######
##########################################################               #######
###########################      #########################     ####      #######
###################      ##      ##        ###############     ####      #######
########      #####          @                                   ##      #######
########                 ##      ##         ###########          ##      #######
########      #####      ##      ##         ###########          ####    #######
#####       #######      ###    ###         ############ ############## ########
#####       #######      ###    ###         ############ ############## ########
#####       #######      #### #####         ##       ##      ########## ########
#####                    #### ######                         ########## ########
#####   <   #######      #### ######        ##       ##      ########## ########
#####       #######      ##      ####### #####       ##      ########## ########
###################              ####### #####       ##      ########## ########
###################      ##      ####### #####       ##      ########## ########
###########################      ######              ############              #
###########################      ######     ##                                 #
###########################                 ######   ############       <      #
###########################      ######     #####################              #
#######################################     #####################              #
################################################################################