#####################
## @  ###############
##    ###############
#### #######      ###
#### #######      ###
####              ###
############      ###
#####################
